#################################################
#                                               #
#                                               #
#    ####   ##  ##   ## ###   ### #####         #
#      #   #  # # # # # #  #   #  #             #
#     #    #  # #  #  # ###    #  ###           #
#     #    #  # #     # #  #   #  #             #
#    #     #  # #     # #  #   #  #             #
#   ####    ##  #     # ###   ### #####         #
#                                               #
#    ##    ##   ##   ## #####                   #
#   #  #  #  #  # # # # #Z                      #
#   #     #  #  #  #  # ###                     #
#   # ##  ####  #     # #                       #
#   # Z#  #  #  #     # #                       #
#    ##   #  #  #     # #####                   #
#                                               #
#                                               #
#                                               #
#                                               #
#                                               #
#                                               #
#                                               #
#                                               #
#                                               #
#                                               #
#                                               #
#                                               #
#                                               #
#                                               #
#                                               #
#                                               #
#  ZZZZZ   ZZ   ZZ   Z ZZZZZ ZZZ                #
#    Z    Z  Z  Z Z  Z Z     Z  Z               #
#    Z    Z  z  Z Z  Z ZZZ   ZZZ                #
#    Z    ZZZZ  Z  Z Z Z     Z  Z               #
#    Z    Z  Z  Z  Z Z Z     Z  Z               #
#    Z    Z  Z  Z   ZZ ZZZZZ ZZZ                #
#                                               #
#                                               #
#                                               #
#                                               #
#                                               #
#                                               #
#                                               #
#                                               #
#                                               #
#                                               #
#                                               #
#################################################
